
echo " ~\$[ M ] .o. @\"src/analyser-gt-norm.hfst\" .o. \$[ {miehttse} ] .o. ~\$[ \"+Cmp\" | \"#\" ] " | hfst-regexp2fst -E -F -f foma | hfst-fst2strings | tr ':' '\t' | grep "\tmiehttse\+" | grep "miehttse+" | sort -u | grep -v "Px"| grep -v "Gen" | grep -v "Acc" | grep -v "Ine" | grep -v "Ela"| grep -v "Ill"  | grep -v "Ess" > fil-med-alle-ordformer-miehttse.txt


I denne listen:
Alle "miehttse" uten Px og uten kasuser forutenom Nom og Com:

Merkelige former:
- miehtsedabbo	miehttse+N+Der/Car+A+Comp+Sg+Nom
- miehtsedamos	miehttse+N+Der/Car+A+Superl+Sg+Nom
- mæhtsálapvuohta	miehttse+N+Der/lasj+A+Comp+Attr+Der/vuota+N+Sg+Nom (finns ikke miehtselasjvuohta)

miehtse	miehttse+N+Pl+Nom
miehtseda	miehttse+N+Abe
miehtsedabbo	miehttse+N+Der/Car+A+Comp+Sg+Nom
miehtsedabmusa	miehttse+N+Der/Car+A+Superl+Pl+Nom
miehtsedabmusadagi	miehttse+N+Der/Car+A+Superl+Sg+Abe
miehtsedabmusadagá	miehttse+N+Der/Car+A+Superl+Sg+Abe
miehtsedabmusatagá	miehttse+N+Der/Car+A+Superl+Sg+Abe
miehtsedabmusij	miehttse+N+Der/Car+A+Superl+Pl+Com
miehtsedabmusijdagi	miehttse+N+Der/Car+A+Superl+Pl+Abe
miehtsedabmusijdagá	miehttse+N+Der/Car+A+Superl+Pl+Abe
miehtsedabmusijn	miehttse+N+Der/Car+A+Superl+Sg+Com
miehtsedabmusijtagá	miehttse+N+Der/Car+A+Superl+Pl+Abe
miehtsedabmusit	miehttse+N+Der/Car+A+Superl+Der/AAdv+Adv
miehtsedagi	miehttse+N+Sg+Abe
miehtsedagá	miehttse+N+Sg+Abe
miehtsedak	miehttse+N+Abe
miehtsedamos	miehttse+N+Der/Car+A+Superl+Attr
miehtsedamos	miehttse+N+Der/Car+A+Superl+Sg+Nom
miehtsedap	miehttse+N+Der/Car+A+Comp+Attr
miehtsedappo	miehttse+N+Der/Car+A+Comp+Pl+Nom
miehtsedappodagi	miehttse+N+Der/Car+A+Comp+Sg+Abe
miehtsedappodagá	miehttse+N+Der/Car+A+Comp+Sg+Abe
miehtsedappoj	miehttse+N+Der/Car+A+Comp+Pl+Com
miehtsedappojdagi	miehttse+N+Der/Car+A+Comp+Pl+Abe
miehtsedappojdagá	miehttse+N+Der/Car+A+Comp+Pl+Abe
miehtsedappojn	miehttse+N+Der/Car+A+Comp+Sg+Com
miehtsedappojtagá	miehttse+N+Der/Car+A+Comp+Pl+Abe
miehtsedappot	miehttse+N+Der/Car+A+Comp+Der/AAdv+Adv
miehtsedappotagá	miehttse+N+Der/Car+A+Comp+Sg+Abe
miehtsedappujn	miehttse+N+Der/Car+A+Comp+Sg+Com
miehtsedappusj	miehttse+N+Der/Car+A+Comp+Der/Dimin+A+Sg+Attr
miehtsedappusj	miehttse+N+Der/Car+A+Comp+Der/Dimin+A+Sg+Nom
miehtsedappusjvuoda	miehttse+N+Der/Car+A+Comp+Der/Dimin+A+Sg+Attr+Der/vuota+N+Pl+Nom
miehtsedappusjvuodada	miehttse+N+Der/Car+A+Comp+Der/Dimin+A+Sg+Attr+Der/vuota+N+Abe
miehtsedappusjvuodadagi	miehttse+N+Der/Car+A+Comp+Der/Dimin+A+Sg+Attr+Der/vuota+N+Sg+Abe
miehtsedappusjvuodadagá	miehttse+N+Der/Car+A+Comp+Der/Dimin+A+Sg+Attr+Der/vuota+N+Sg+Abe
miehtsedappusjvuodadak	miehttse+N+Der/Car+A+Comp+Der/Dimin+A+Sg+Attr+Der/vuota+N+Abe
miehtsedappusjvuodaj	miehttse+N+Der/Car+A+Comp+Der/Dimin+A+Sg+Attr+Der/vuota+N+Pl+Com
miehtsedappusjvuodajdagi	miehttse+N+Der/Car+A+Comp+Der/Dimin+A+Sg+Attr+Der/vuota+N+Pl+Abe
miehtsedappusjvuodajdagá	miehttse+N+Der/Car+A+Comp+Der/Dimin+A+Sg+Attr+Der/vuota+N+Pl+Abe
miehtsedappusjvuodajn	miehttse+N+Der/Car+A+Comp+Der/Dimin+A+Sg+Attr+Der/vuota+N+Sg+Com
miehtsedappusjvuohta	miehttse+N+Der/Car+A+Comp+Der/Dimin+A+Sg+Attr+Der/vuota+N+Sg+Nom
miehtsedapputja	miehttse+N+Der/Car+A+Comp+Der/Dimin+A+Pl+Nom
miehtsedapputjadagi	miehttse+N+Der/Car+A+Comp+Der/Dimin+A+Sg+Abe
miehtsedapputjadagá	miehttse+N+Der/Car+A+Comp+Der/Dimin+A+Sg+Abe
miehtsedapputjatagá	miehttse+N+Der/Car+A+Comp+Der/Dimin+A+Sg+Abe
miehtsedapputjij	miehttse+N+Der/Car+A+Comp+Der/Dimin+A+Pl+Com
miehtsedapputjijdagi	miehttse+N+Der/Car+A+Comp+Der/Dimin+A+Pl+Abe
miehtsedapputjijdagá	miehttse+N+Der/Car+A+Comp+Der/Dimin+A+Pl+Abe
miehtsedapputjijn	miehttse+N+Der/Car+A+Comp+Der/Dimin+A+Sg+Com
miehtsedapputjijtagá	miehttse+N+Der/Car+A+Comp+Der/Dimin+A+Pl+Abe
miehtsedapputjit	miehttse+N+Der/Car+A+Comp+Der/Dimin+A+Der/AAdv+Adv
miehtsedapvuoda	miehttse+N+Der/Car+A+Comp+Attr+Der/vuota+N+Pl+Nom
miehtsedapvuodada	miehttse+N+Der/Car+A+Comp+Attr+Der/vuota+N+Abe
miehtsedapvuodadagi	miehttse+N+Der/Car+A+Comp+Attr+Der/vuota+N+Sg+Abe
miehtsedapvuodadagá	miehttse+N+Der/Car+A+Comp+Attr+Der/vuota+N+Sg+Abe
miehtsedapvuodadak	miehttse+N+Der/Car+A+Comp+Attr+Der/vuota+N+Abe
miehtsedapvuodaj	miehttse+N+Der/Car+A+Comp+Attr+Der/vuota+N+Pl+Com
miehtsedapvuodajdagi	miehttse+N+Der/Car+A+Comp+Attr+Der/vuota+N+Pl+Abe
miehtsedapvuodajdagá	miehttse+N+Der/Car+A+Comp+Attr+Der/vuota+N+Pl+Abe
miehtsedapvuodajn	miehttse+N+Der/Car+A+Comp+Attr+Der/vuota+N+Sg+Com
miehtsedapvuohta	miehttse+N+Der/Car+A+Comp+Attr+Der/vuota+N+Sg+Nom
miehtsedibme	miehttse+N+Der/Car+A+Sg+Nom
miehtsedime	miehttse+N+Der/Car+A+Pl+Nom
miehtsedimedagi	miehttse+N+Der/Car+A+Sg+Abe
miehtsedimedagá	miehttse+N+Der/Car+A+Sg+Abe
miehtsedimet	miehttse+N+Der/Car+A+Der/AAdv+Adv
miehtsedimij	miehttse+N+Der/Car+A+Pl+Com
miehtsedimijdagi	miehttse+N+Der/Car+A+Pl+Abe
miehtsedimijdagá	miehttse+N+Der/Car+A+Pl+Abe
miehtsedimijn	miehttse+N+Der/Car+A+Sg+Com
miehtsedis	miehttse+N+Der/Car+A+Attr
miehtsedisvuoda	miehttse+N+Der/Car+A+Attr+Der/vuota+N+Pl+Nom
miehtsedisvuodada	miehttse+N+Der/Car+A+Attr+Der/vuota+N+Abe
miehtsedisvuodadagi	miehttse+N+Der/Car+A+Attr+Der/vuota+N+Sg+Abe
miehtsedisvuodadagá	miehttse+N+Der/Car+A+Attr+Der/vuota+N+Sg+Abe
miehtsedisvuodadak	miehttse+N+Der/Car+A+Attr+Der/vuota+N+Abe
miehtsedisvuodaj	miehttse+N+Der/Car+A+Attr+Der/vuota+N+Pl+Com
miehtsedisvuodajdagi	miehttse+N+Der/Car+A+Attr+Der/vuota+N+Pl+Abe
miehtsedisvuodajdagá	miehttse+N+Der/Car+A+Attr+Der/vuota+N+Pl+Abe
miehtsedisvuodajn	miehttse+N+Der/Car+A+Attr+Der/vuota+N+Sg+Com
miehtsedisvuohta	miehttse+N+Der/Car+A+Attr+Der/vuota+N+Sg+Nom
miehtsedup	miehttse+N+Der/Car+A+Comp+Attr
miehtsedupvuoda	miehttse+N+Der/Car+A+Comp+Attr+Der/vuota+N+Pl+Nom
miehtsedupvuodada	miehttse+N+Der/Car+A+Comp+Attr+Der/vuota+N+Abe
miehtsedupvuodadagi	miehttse+N+Der/Car+A+Comp+Attr+Der/vuota+N+Sg+Abe
miehtsedupvuodadagá	miehttse+N+Der/Car+A+Comp+Attr+Der/vuota+N+Sg+Abe
miehtsedupvuodadak	miehttse+N+Der/Car+A+Comp+Attr+Der/vuota+N+Abe
miehtsedupvuodaj	miehttse+N+Der/Car+A+Comp+Attr+Der/vuota+N+Pl+Com
miehtsedupvuodajdagi	miehttse+N+Der/Car+A+Comp+Attr+Der/vuota+N+Pl+Abe
miehtsedupvuodajdagá	miehttse+N+Der/Car+A+Comp+Attr+Der/vuota+N+Pl+Abe
miehtsedupvuodajn	miehttse+N+Der/Car+A+Comp+Attr+Der/vuota+N+Sg+Com
miehtsedupvuohta	miehttse+N+Der/Car+A+Comp+Attr+Der/vuota+N+Sg+Nom
miehtsij	miehttse+N+Pl+Com
miehtsijdagi	miehttse+N+Pl+Abe
miehtsijdagá	miehttse+N+Pl+Abe
miehtsijn	miehttse+N+Sg+Com
miehttse	miehttse+N+Sg+Nommæhtsálabbo	miehttse+N+Der/lasj+A+Comp+Sg+Nom
mæhtsálabmusa	miehttse+N+Der/lasj+A+Superl+Pl+Nom
mæhtsálabmusadagi	miehttse+N+Der/lasj+A+Superl+Sg+Abe
mæhtsálabmusadagá	miehttse+N+Der/lasj+A+Superl+Sg+Abe
mæhtsálabmusatagá	miehttse+N+Der/lasj+A+Superl+Sg+Abe
mæhtsálabmusij	miehttse+N+Der/lasj+A+Superl+Pl+Com
mæhtsálabmusijdagi	miehttse+N+Der/lasj+A+Superl+Pl+Abe
mæhtsálabmusijdagá	miehttse+N+Der/lasj+A+Superl+Pl+Abe
mæhtsálabmusijn	miehttse+N+Der/lasj+A+Superl+Sg+Com
mæhtsálabmusijtagá	miehttse+N+Der/lasj+A+Superl+Pl+Abe
mæhtsálabmusit	miehttse+N+Der/lasj+A+Superl+Der/AAdv+Adv
mæhtsálamos	miehttse+N+Der/lasj+A+Superl+Attr
mæhtsálamos	miehttse+N+Der/lasj+A+Superl+Sg+Nom
mæhtsálap	miehttse+N+Der/lasj+A+Comp+Attr
mæhtsálappo	miehttse+N+Der/lasj+A+Comp+Pl+Nom
mæhtsálappodagi	miehttse+N+Der/lasj+A+Comp+Sg+Abe
mæhtsálappodagá	miehttse+N+Der/lasj+A+Comp+Sg+Abe
mæhtsálappoj	miehttse+N+Der/lasj+A+Comp+Pl+Com
mæhtsálappojdagi	miehttse+N+Der/lasj+A+Comp+Pl+Abe
mæhtsálappojdagá	miehttse+N+Der/lasj+A+Comp+Pl+Abe
mæhtsálappojn	miehttse+N+Der/lasj+A+Comp+Sg+Com
mæhtsálappojtagá	miehttse+N+Der/lasj+A+Comp+Pl+Abe
mæhtsálappot	miehttse+N+Der/lasj+A+Comp+Der/AAdv+Adv
mæhtsálappotagá	miehttse+N+Der/lasj+A+Comp+Sg+Abe
mæhtsálappujn	miehttse+N+Der/lasj+A+Comp+Sg+Com
mæhtsálappusj	miehttse+N+Der/lasj+A+Comp+Der/Dimin+A+Sg+Attr
mæhtsálappusj	miehttse+N+Der/lasj+A+Comp+Der/Dimin+A+Sg+Nom
mæhtsálappusjvuoda	miehttse+N+Der/lasj+A+Comp+Der/Dimin+A+Sg+Attr+Der/vuota+N+Pl+Nom
mæhtsálappusjvuodada	miehttse+N+Der/lasj+A+Comp+Der/Dimin+A+Sg+Attr+Der/vuota+N+Abe
mæhtsálappusjvuodadagi	miehttse+N+Der/lasj+A+Comp+Der/Dimin+A+Sg+Attr+Der/vuota+N+Sg+Abe
mæhtsálappusjvuodadagá	miehttse+N+Der/lasj+A+Comp+Der/Dimin+A+Sg+Attr+Der/vuota+N+Sg+Abe
mæhtsálappusjvuodadak	miehttse+N+Der/lasj+A+Comp+Der/Dimin+A+Sg+Attr+Der/vuota+N+Abe
mæhtsálappusjvuodaj	miehttse+N+Der/lasj+A+Comp+Der/Dimin+A+Sg+Attr+Der/vuota+N+Pl+Com
mæhtsálappusjvuodajdagi	miehttse+N+Der/lasj+A+Comp+Der/Dimin+A+Sg+Attr+Der/vuota+N+Pl+Abe
mæhtsálappusjvuodajdagá	miehttse+N+Der/lasj+A+Comp+Der/Dimin+A+Sg+Attr+Der/vuota+N+Pl+Abe
mæhtsálappusjvuodajn	miehttse+N+Der/lasj+A+Comp+Der/Dimin+A+Sg+Attr+Der/vuota+N+Sg+Com
mæhtsálappusjvuohta	miehttse+N+Der/lasj+A+Comp+Der/Dimin+A+Sg+Attr+Der/vuota+N+Sg+Nom
mæhtsálapputja	miehttse+N+Der/lasj+A+Comp+Der/Dimin+A+Pl+Nom
mæhtsálapputjadagi	miehttse+N+Der/lasj+A+Comp+Der/Dimin+A+Sg+Abe
mæhtsálapputjadagá	miehttse+N+Der/lasj+A+Comp+Der/Dimin+A+Sg+Abe
mæhtsálapputjatagá	miehttse+N+Der/lasj+A+Comp+Der/Dimin+A+Sg+Abe
mæhtsálapputjij	miehttse+N+Der/lasj+A+Comp+Der/Dimin+A+Pl+Com
mæhtsálapputjijdagi	miehttse+N+Der/lasj+A+Comp+Der/Dimin+A+Pl+Abe
mæhtsálapputjijdagá	miehttse+N+Der/lasj+A+Comp+Der/Dimin+A+Pl+Abe
mæhtsálapputjijn	miehttse+N+Der/lasj+A+Comp+Der/Dimin+A+Sg+Com
mæhtsálapputjijtagá	miehttse+N+Der/lasj+A+Comp+Der/Dimin+A+Pl+Abe
mæhtsálapputjit	miehttse+N+Der/lasj+A+Comp+Der/Dimin+A+Der/AAdv+Adv
mæhtsálapvuoda	miehttse+N+Der/lasj+A+Comp+Attr+Der/vuota+N+Pl+Nom
mæhtsálapvuodada	miehttse+N+Der/lasj+A+Comp+Attr+Der/vuota+N+Abe
mæhtsálapvuodadagi	miehttse+N+Der/lasj+A+Comp+Attr+Der/vuota+N+Sg+Abe
mæhtsálapvuodadagá	miehttse+N+Der/lasj+A+Comp+Attr+Der/vuota+N+Sg+Abe
mæhtsálapvuodadak	miehttse+N+Der/lasj+A+Comp+Attr+Der/vuota+N+Abe
mæhtsálapvuodaj	miehttse+N+Der/lasj+A+Comp+Attr+Der/vuota+N+Pl+Com
mæhtsálapvuodajdagi	miehttse+N+Der/lasj+A+Comp+Attr+Der/vuota+N+Pl+Abe
mæhtsálapvuodajdagá	miehttse+N+Der/lasj+A+Comp+Attr+Der/vuota+N+Pl+Abe
mæhtsálapvuodajn	miehttse+N+Der/lasj+A+Comp+Attr+Der/vuota+N+Sg+Com
mæhtsálapvuohta	miehttse+N+Der/lasj+A+Comp+Attr+Der/vuota+N+Sg+Nom
mæhtsálasj	miehttse+N+Der/lasj+A+Attr
mæhtsálasj	miehttse+N+Der/lasj+A+Sg+Nom
mæhtsálasjvuoda	miehttse+N+Der/lasj+A+Attr+Der/vuota+N+Pl+Nom
mæhtsálasjvuodada	miehttse+N+Der/lasj+A+Attr+Der/vuota+N+Abe
mæhtsálasjvuodadagi	miehttse+N+Der/lasj+A+Attr+Der/vuota+N+Sg+Abe
mæhtsálasjvuodadagá	miehttse+N+Der/lasj+A+Attr+Der/vuota+N+Sg+Abe
mæhtsálasjvuodadak	miehttse+N+Der/lasj+A+Attr+Der/vuota+N+Abe
mæhtsálasjvuodaj	miehttse+N+Der/lasj+A+Attr+Der/vuota+N+Pl+Com
mæhtsálasjvuodajdagi	miehttse+N+Der/lasj+A+Attr+Der/vuota+N+Pl+Abe
mæhtsálasjvuodajdagá	miehttse+N+Der/lasj+A+Attr+Der/vuota+N+Pl+Abe
mæhtsálasjvuodajn	miehttse+N+Der/lasj+A+Attr+Der/vuota+N+Sg+Com
mæhtsálasjvuohta	miehttse+N+Der/lasj+A+Attr+Der/vuota+N+Sg+Nom
mæhtsálattja	miehttse+N+Der/lasj+A+Pl+Nom
mæhtsálattjadagi	miehttse+N+Der/lasj+A+Sg+Abe
mæhtsálattjadagá	miehttse+N+Der/lasj+A+Sg+Abe
mæhtsálattjaj	miehttse+N+Der/lasj+A+Pl+Com
mæhtsálattjajdagi	miehttse+N+Der/lasj+A+Pl+Abe
mæhtsálattjajdagá	miehttse+N+Der/lasj+A+Pl+Abe
mæhtsálattjajn	miehttse+N+Der/lasj+A+Sg+Com
mæhtsálattjat	miehttse+N+Der/lasj+A+Der/AAdv+Adv
mæhtsálup	miehttse+N+Der/lasj+A+Comp+Attr
mæhtsálupvuoda	miehttse+N+Der/lasj+A+Comp+Attr+Der/vuota+N+Pl+Nom
mæhtsálupvuodada	miehttse+N+Der/lasj+A+Comp+Attr+Der/vuota+N+Abe
mæhtsálupvuodadagi	miehttse+N+Der/lasj+A+Comp+Attr+Der/vuota+N+Sg+Abe
mæhtsálupvuodadagá	miehttse+N+Der/lasj+A+Comp+Attr+Der/vuota+N+Sg+Abe
mæhtsálupvuodadak	miehttse+N+Der/lasj+A+Comp+Attr+Der/vuota+N+Abe
mæhtsálupvuodaj	miehttse+N+Der/lasj+A+Comp+Attr+Der/vuota+N+Pl+Com
mæhtsálupvuodajdagi	miehttse+N+Der/lasj+A+Comp+Attr+Der/vuota+N+Pl+Abe
mæhtsálupvuodajdagá	miehttse+N+Der/lasj+A+Comp+Attr+Der/vuota+N+Pl+Abe
mæhtsálupvuodajn	miehttse+N+Der/lasj+A+Comp+Attr+Der/vuota+N+Sg+Com
mæhtsálupvuohta	miehttse+N+Der/lasj+A+Comp+Attr+Der/vuota+N+Sg+Nom
mæhtsásj	miehttse+N+Der/Dimin+N+Sg+Nom
mæhtsátja	miehttse+N+Der/Dimin+N+Pl+Nom
mæhtsátjadagi	miehttse+N+Der/Dimin+N+Sg+Abe
mæhtsátjadagá	miehttse+N+Der/Dimin+N+Sg+Abe
mæhtsátjasj	miehttse+N+Der/Dimin+N+Der/Dimin+N+Sg+Nom
mæhtsátjattja	miehttse+N+Der/Dimin+N+Der/Dimin+N+Pl+Nom
mæhtsátjattjadagi	miehttse+N+Der/Dimin+N+Der/Dimin+N+Sg+Abe
mæhtsátjattjadagá	miehttse+N+Der/Dimin+N+Der/Dimin+N+Sg+Abe
mæhtsátjattjaj	miehttse+N+Der/Dimin+N+Der/Dimin+N+Pl+Com
mæhtsátjattjajdagi	miehttse+N+Der/Dimin+N+Der/Dimin+N+Pl+Abe
mæhtsátjattjajdagá	miehttse+N+Der/Dimin+N+Der/Dimin+N+Pl+Abe
mæhtsátjattjajn	miehttse+N+Der/Dimin+N+Der/Dimin+N+Sg+Com
mæhtsátjij	miehttse+N+Der/Dimin+N+Pl+Com
mæhtsátjijdagi	miehttse+N+Der/Dimin+N+Pl+Abe
mæhtsátjijdagá	miehttse+N+Der/Dimin+N+Pl+Abe
mæhtsátjijn	miehttse+N+Der/Dimin+N+Sg+Com
