nuora	nuorra+A+Pl+Nom
nuora	nuorra+N+Pl+Nom
nuorabu	nuorra+A+Comp+Pl+Nom
nuorabudagi	nuorra+A+Comp+Sg+Abe
nuorabudagá	nuorra+A+Comp+Sg+Abe
nuorabuj	nuorra+A+Comp+Pl+Com
nuorabujdagi	nuorra+A+Comp+Pl+Abe
nuorabujdagá	nuorra+A+Comp+Pl+Abe
nuorabujn	nuorra+A+Comp+Sg+Com
nuorabujtagá	nuorra+A+Comp+Pl+Abe
nuorabusj	nuorra+A+Comp+Der/Dimin+A+Sg+Attr
nuorabusj	nuorra+A+Comp+Der/Dimin+A+Sg+Nom
nuorabusjvuoda	nuorra+A+Comp+Der/Dimin+A+Sg+Attr+Der/vuota+N+Pl+Nom
nuorabusjvuodada	nuorra+A+Comp+Der/Dimin+A+Sg+Attr+Der/vuota+N+Abe
nuorabusjvuodadagi	nuorra+A+Comp+Der/Dimin+A+Sg+Attr+Der/vuota+N+Sg+Abe
nuorabusjvuodadagá	nuorra+A+Comp+Der/Dimin+A+Sg+Attr+Der/vuota+N+Sg+Abe
nuorabusjvuodadak	nuorra+A+Comp+Der/Dimin+A+Sg+Attr+Der/vuota+N+Abe
nuorabusjvuodaj	nuorra+A+Comp+Der/Dimin+A+Sg+Attr+Der/vuota+N+Pl+Com
nuorabusjvuodajdagi	nuorra+A+Comp+Der/Dimin+A+Sg+Attr+Der/vuota+N+Pl+Abe
nuorabusjvuodajdagá	nuorra+A+Comp+Der/Dimin+A+Sg+Attr+Der/vuota+N+Pl+Abe
nuorabusjvuodajn	nuorra+A+Comp+Der/Dimin+A+Sg+Attr+Der/vuota+N+Sg+Com
nuorabusjvuohta	nuorra+A+Comp+Der/Dimin+A+Sg+Attr+Der/vuota+N+Sg+Nom
nuorabut	nuorra+A+Comp+Der/AAdv+Adv
nuorabutagá	nuorra+A+Comp+Sg+Abe
nuorabuttja	nuorra+A+Comp+Der/Dimin+A+Pl+Nom
nuorabuttjadagi	nuorra+A+Comp+Der/Dimin+A+Sg+Abe
nuorabuttjadagá	nuorra+A+Comp+Der/Dimin+A+Sg+Abe
nuorabuttjaj	nuorra+A+Comp+Der/Dimin+A+Pl+Com
nuorabuttjajdagi	nuorra+A+Comp+Der/Dimin+A+Pl+Abe
nuorabuttjajdagá	nuorra+A+Comp+Der/Dimin+A+Pl+Abe
nuorabuttjajn	nuorra+A+Comp+Der/Dimin+A+Sg+Com
nuorabuttjajtagá	nuorra+A+Comp+Der/Dimin+A+Pl+Abe
nuorabuttjat	nuorra+A+Comp+Der/Dimin+A+Der/AAdv+Adv
nuorabuttjatagá	nuorra+A+Comp+Der/Dimin+A+Sg+Abe
nuorada	nuorra+N+Abe
nuoradabbo	nuorra+N+Der/Car+A+Comp+Sg+Nom
nuoradabmusa	nuorra+N+Der/Car+A+Superl+Pl+Nom
nuoradabmusadagi	nuorra+N+Der/Car+A+Superl+Sg+Abe
nuoradabmusadagá	nuorra+N+Der/Car+A+Superl+Sg+Abe
nuoradabmusatagá	nuorra+N+Der/Car+A+Superl+Sg+Abe
nuoradabmusij	nuorra+N+Der/Car+A+Superl+Pl+Com
nuoradabmusijdagi	nuorra+N+Der/Car+A+Superl+Pl+Abe
nuoradabmusijdagá	nuorra+N+Der/Car+A+Superl+Pl+Abe
nuoradabmusijn	nuorra+N+Der/Car+A+Superl+Sg+Com
nuoradabmusijtagá	nuorra+N+Der/Car+A+Superl+Pl+Abe
nuoradabmusit	nuorra+N+Der/Car+A+Superl+Der/AAdv+Adv
nuoradagi	nuorra+A+Sg+Abe
nuoradagi	nuorra+N+Sg+Abe
nuoradagá	nuorra+A+Sg+Abe
nuoradagá	nuorra+N+Sg+Abe
nuoradak	nuorra+N+Abe
nuoradamos	nuorra+N+Der/Car+A+Superl+Attr
nuoradamos	nuorra+N+Der/Car+A+Superl+Sg+Nom
nuoradap	nuorra+N+Der/Car+A+Comp+Attr
nuoradappo	nuorra+N+Der/Car+A+Comp+Pl+Nom
nuoradappodagi	nuorra+N+Der/Car+A+Comp+Sg+Abe
nuoradappodagá	nuorra+N+Der/Car+A+Comp+Sg+Abe
nuoradappoj	nuorra+N+Der/Car+A+Comp+Pl+Com
nuoradappojdagi	nuorra+N+Der/Car+A+Comp+Pl+Abe
nuoradappojdagá	nuorra+N+Der/Car+A+Comp+Pl+Abe
nuoradappojn	nuorra+N+Der/Car+A+Comp+Sg+Com
nuoradappojtagá	nuorra+N+Der/Car+A+Comp+Pl+Abe
nuoradappot	nuorra+N+Der/Car+A+Comp+Der/AAdv+Adv
nuoradappotagá	nuorra+N+Der/Car+A+Comp+Sg+Abe
nuoradappujn	nuorra+N+Der/Car+A+Comp+Sg+Com
nuoradappusj	nuorra+N+Der/Car+A+Comp+Der/Dimin+A+Sg+Attr
nuoradappusj	nuorra+N+Der/Car+A+Comp+Der/Dimin+A+Sg+Nom
nuoradappusjvuoda	nuorra+N+Der/Car+A+Comp+Der/Dimin+A+Sg+Attr+Der/vuota+N+Pl+Nom
nuoradappusjvuodada	nuorra+N+Der/Car+A+Comp+Der/Dimin+A+Sg+Attr+Der/vuota+N+Abe
nuoradappusjvuodadagi	nuorra+N+Der/Car+A+Comp+Der/Dimin+A+Sg+Attr+Der/vuota+N+Sg+Abe
nuoradappusjvuodadagá	nuorra+N+Der/Car+A+Comp+Der/Dimin+A+Sg+Attr+Der/vuota+N+Sg+Abe
nuoradappusjvuodadak	nuorra+N+Der/Car+A+Comp+Der/Dimin+A+Sg+Attr+Der/vuota+N+Abe
nuoradappusjvuodaj	nuorra+N+Der/Car+A+Comp+Der/Dimin+A+Sg+Attr+Der/vuota+N+Pl+Com
nuoradappusjvuodajdagi	nuorra+N+Der/Car+A+Comp+Der/Dimin+A+Sg+Attr+Der/vuota+N+Pl+Abe
nuoradappusjvuodajdagá	nuorra+N+Der/Car+A+Comp+Der/Dimin+A+Sg+Attr+Der/vuota+N+Pl+Abe
nuoradappusjvuodajn	nuorra+N+Der/Car+A+Comp+Der/Dimin+A+Sg+Attr+Der/vuota+N+Sg+Com
nuoradappusjvuohta	nuorra+N+Der/Car+A+Comp+Der/Dimin+A+Sg+Attr+Der/vuota+N+Sg+Nom
nuoradapputja	nuorra+N+Der/Car+A+Comp+Der/Dimin+A+Pl+Nom
nuoradapputjadagi	nuorra+N+Der/Car+A+Comp+Der/Dimin+A+Sg+Abe
nuoradapputjadagá	nuorra+N+Der/Car+A+Comp+Der/Dimin+A+Sg+Abe
nuoradapputjatagá	nuorra+N+Der/Car+A+Comp+Der/Dimin+A+Sg+Abe
nuoradapputjij	nuorra+N+Der/Car+A+Comp+Der/Dimin+A+Pl+Com
nuoradapputjijdagi	nuorra+N+Der/Car+A+Comp+Der/Dimin+A+Pl+Abe
nuoradapputjijdagá	nuorra+N+Der/Car+A+Comp+Der/Dimin+A+Pl+Abe
nuoradapputjijn	nuorra+N+Der/Car+A+Comp+Der/Dimin+A+Sg+Com
nuoradapputjijtagá	nuorra+N+Der/Car+A+Comp+Der/Dimin+A+Pl+Abe
nuoradapputjit	nuorra+N+Der/Car+A+Comp+Der/Dimin+A+Der/AAdv+Adv
nuoradapvuoda	nuorra+N+Der/Car+A+Comp+Attr+Der/vuota+N+Pl+Nom
nuoradapvuodada	nuorra+N+Der/Car+A+Comp+Attr+Der/vuota+N+Abe
nuoradapvuodadagi	nuorra+N+Der/Car+A+Comp+Attr+Der/vuota+N+Sg+Abe
nuoradapvuodadagá	nuorra+N+Der/Car+A+Comp+Attr+Der/vuota+N+Sg+Abe
nuoradapvuodadak	nuorra+N+Der/Car+A+Comp+Attr+Der/vuota+N+Abe
nuoradapvuodaj	nuorra+N+Der/Car+A+Comp+Attr+Der/vuota+N+Pl+Com
nuoradapvuodajdagi	nuorra+N+Der/Car+A+Comp+Attr+Der/vuota+N+Pl+Abe
nuoradapvuodajdagá	nuorra+N+Der/Car+A+Comp+Attr+Der/vuota+N+Pl+Abe
nuoradapvuodajn	nuorra+N+Der/Car+A+Comp+Attr+Der/vuota+N+Sg+Com
nuoradapvuohta	nuorra+N+Der/Car+A+Comp+Attr+Der/vuota+N+Sg+Nom
nuoradibme	nuorra+N+Der/Car+A+Sg+Nom
nuoradime	nuorra+N+Der/Car+A+Pl+Nom
nuoradimedagi	nuorra+N+Der/Car+A+Sg+Abe
nuoradimedagá	nuorra+N+Der/Car+A+Sg+Abe
nuoradimet	nuorra+N+Der/Car+A+Der/AAdv+Adv
nuoradimij	nuorra+N+Der/Car+A+Pl+Com
nuoradimijdagi	nuorra+N+Der/Car+A+Pl+Abe
nuoradimijdagá	nuorra+N+Der/Car+A+Pl+Abe
nuoradimijn	nuorra+N+Der/Car+A+Sg+Com
nuoradis	nuorra+N+Der/Car+A+Attr
nuoradisvuoda	nuorra+N+Der/Car+A+Attr+Der/vuota+N+Pl+Nom
nuoradisvuodada	nuorra+N+Der/Car+A+Attr+Der/vuota+N+Abe
nuoradisvuodadagi	nuorra+N+Der/Car+A+Attr+Der/vuota+N+Sg+Abe
nuoradisvuodadagá	nuorra+N+Der/Car+A+Attr+Der/vuota+N+Sg+Abe
nuoradisvuodadak	nuorra+N+Der/Car+A+Attr+Der/vuota+N+Abe
nuoradisvuodaj	nuorra+N+Der/Car+A+Attr+Der/vuota+N+Pl+Com
nuoradisvuodajdagi	nuorra+N+Der/Car+A+Attr+Der/vuota+N+Pl+Abe
nuoradisvuodajdagá	nuorra+N+Der/Car+A+Attr+Der/vuota+N+Pl+Abe
nuoradisvuodajn	nuorra+N+Der/Car+A+Attr+Der/vuota+N+Sg+Com
nuoradisvuohta	nuorra+N+Der/Car+A+Attr+Der/vuota+N+Sg+Nom
nuoradup	nuorra+N+Der/Car+A+Comp+Attr
nuoradupvuoda	nuorra+N+Der/Car+A+Comp+Attr+Der/vuota+N+Pl+Nom
nuoradupvuodada	nuorra+N+Der/Car+A+Comp+Attr+Der/vuota+N+Abe
nuoradupvuodadagi	nuorra+N+Der/Car+A+Comp+Attr+Der/vuota+N+Sg+Abe
nuoradupvuodadagá	nuorra+N+Der/Car+A+Comp+Attr+Der/vuota+N+Sg+Abe
nuoradupvuodadak	nuorra+N+Der/Car+A+Comp+Attr+Der/vuota+N+Abe
nuoradupvuodaj	nuorra+N+Der/Car+A+Comp+Attr+Der/vuota+N+Pl+Com
nuoradupvuodajdagi	nuorra+N+Der/Car+A+Comp+Attr+Der/vuota+N+Pl+Abe
nuoradupvuodajdagá	nuorra+N+Der/Car+A+Comp+Attr+Der/vuota+N+Pl+Abe
nuoradupvuodajn	nuorra+N+Der/Car+A+Comp+Attr+Der/vuota+N+Sg+Com
nuoradupvuohta	nuorra+N+Der/Car+A+Comp+Attr+Der/vuota+N+Sg+Nom
nuoraj	nuorra+A+Pl+Com
nuoraj	nuorra+N+Pl+Com
nuorajdagi	nuorra+A+Pl+Abe
nuorajdagi	nuorra+N+Pl+Abe
nuorajdagá	nuorra+A+Pl+Abe
nuorajdagá	nuorra+N+Pl+Abe
nuorajn	nuorra+A+Sg+Com
nuorajn	nuorra+N+Sg+Com
nuoralabbo	nuorra+N+Der/lasj+A+Comp+Sg+Nom
nuoralabmusa	nuorra+N+Der/lasj+A+Superl+Pl+Nom
nuoralabmusadagi	nuorra+N+Der/lasj+A+Superl+Sg+Abe
nuoralabmusadagá	nuorra+N+Der/lasj+A+Superl+Sg+Abe
nuoralabmusatagá	nuorra+N+Der/lasj+A+Superl+Sg+Abe
nuoralabmusij	nuorra+N+Der/lasj+A+Superl+Pl+Com
nuoralabmusijdagi	nuorra+N+Der/lasj+A+Superl+Pl+Abe
nuoralabmusijdagá	nuorra+N+Der/lasj+A+Superl+Pl+Abe
nuoralabmusijn	nuorra+N+Der/lasj+A+Superl+Sg+Com
nuoralabmusijtagá	nuorra+N+Der/lasj+A+Superl+Pl+Abe
nuoralabmusit	nuorra+N+Der/lasj+A+Superl+Der/AAdv+Adv
nuoralamos	nuorra+N+Der/lasj+A+Superl+Attr
nuoralamos	nuorra+N+Der/lasj+A+Superl+Sg+Nom
nuoralap	nuorra+N+Der/lasj+A+Comp+Attr
nuoralappo	nuorra+N+Der/lasj+A+Comp+Pl+Nom
nuoralappodagi	nuorra+N+Der/lasj+A+Comp+Sg+Abe
nuoralappodagá	nuorra+N+Der/lasj+A+Comp+Sg+Abe
nuoralappoj	nuorra+N+Der/lasj+A+Comp+Pl+Com
nuoralappojdagi	nuorra+N+Der/lasj+A+Comp+Pl+Abe
nuoralappojdagá	nuorra+N+Der/lasj+A+Comp+Pl+Abe
nuoralappojn	nuorra+N+Der/lasj+A+Comp+Sg+Com
nuoralappojtagá	nuorra+N+Der/lasj+A+Comp+Pl+Abe
nuoralappot	nuorra+N+Der/lasj+A+Comp+Der/AAdv+Adv
nuoralappotagá	nuorra+N+Der/lasj+A+Comp+Sg+Abe
nuoralappujn	nuorra+N+Der/lasj+A+Comp+Sg+Com
nuoralappusj	nuorra+N+Der/lasj+A+Comp+Der/Dimin+A+Sg+Attr
nuoralappusj	nuorra+N+Der/lasj+A+Comp+Der/Dimin+A+Sg+Nom
nuoralappusjvuoda	nuorra+N+Der/lasj+A+Comp+Der/Dimin+A+Sg+Attr+Der/vuota+N+Pl+Nom
nuoralappusjvuodada	nuorra+N+Der/lasj+A+Comp+Der/Dimin+A+Sg+Attr+Der/vuota+N+Abe
nuoralappusjvuodadagi	nuorra+N+Der/lasj+A+Comp+Der/Dimin+A+Sg+Attr+Der/vuota+N+Sg+Abe
nuoralappusjvuodadagá	nuorra+N+Der/lasj+A+Comp+Der/Dimin+A+Sg+Attr+Der/vuota+N+Sg+Abe
nuoralappusjvuodadak	nuorra+N+Der/lasj+A+Comp+Der/Dimin+A+Sg+Attr+Der/vuota+N+Abe
nuoralappusjvuodaj	nuorra+N+Der/lasj+A+Comp+Der/Dimin+A+Sg+Attr+Der/vuota+N+Pl+Com
nuoralappusjvuodajdagi	nuorra+N+Der/lasj+A+Comp+Der/Dimin+A+Sg+Attr+Der/vuota+N+Pl+Abe
nuoralappusjvuodajdagá	nuorra+N+Der/lasj+A+Comp+Der/Dimin+A+Sg+Attr+Der/vuota+N+Pl+Abe
nuoralappusjvuodajn	nuorra+N+Der/lasj+A+Comp+Der/Dimin+A+Sg+Attr+Der/vuota+N+Sg+Com
nuoralappusjvuohta	nuorra+N+Der/lasj+A+Comp+Der/Dimin+A+Sg+Attr+Der/vuota+N+Sg+Nom
nuoralapputja	nuorra+N+Der/lasj+A+Comp+Der/Dimin+A+Pl+Nom
nuoralapputjadagi	nuorra+N+Der/lasj+A+Comp+Der/Dimin+A+Sg+Abe
nuoralapputjadagá	nuorra+N+Der/lasj+A+Comp+Der/Dimin+A+Sg+Abe
nuoralapputjatagá	nuorra+N+Der/lasj+A+Comp+Der/Dimin+A+Sg+Abe
nuoralapputjij	nuorra+N+Der/lasj+A+Comp+Der/Dimin+A+Pl+Com
nuoralapputjijdagi	nuorra+N+Der/lasj+A+Comp+Der/Dimin+A+Pl+Abe
nuoralapputjijdagá	nuorra+N+Der/lasj+A+Comp+Der/Dimin+A+Pl+Abe
nuoralapputjijn	nuorra+N+Der/lasj+A+Comp+Der/Dimin+A+Sg+Com
nuoralapputjijtagá	nuorra+N+Der/lasj+A+Comp+Der/Dimin+A+Pl+Abe
nuoralapputjit	nuorra+N+Der/lasj+A+Comp+Der/Dimin+A+Der/AAdv+Adv
nuoralapvuoda	nuorra+N+Der/lasj+A+Comp+Attr+Der/vuota+N+Pl+Nom
nuoralapvuodada	nuorra+N+Der/lasj+A+Comp+Attr+Der/vuota+N+Abe
nuoralapvuodadagi	nuorra+N+Der/lasj+A+Comp+Attr+Der/vuota+N+Sg+Abe
nuoralapvuodadagá	nuorra+N+Der/lasj+A+Comp+Attr+Der/vuota+N+Sg+Abe
nuoralapvuodadak	nuorra+N+Der/lasj+A+Comp+Attr+Der/vuota+N+Abe
nuoralapvuodaj	nuorra+N+Der/lasj+A+Comp+Attr+Der/vuota+N+Pl+Com
nuoralapvuodajdagi	nuorra+N+Der/lasj+A+Comp+Attr+Der/vuota+N+Pl+Abe
nuoralapvuodajdagá	nuorra+N+Der/lasj+A+Comp+Attr+Der/vuota+N+Pl+Abe
nuoralapvuodajn	nuorra+N+Der/lasj+A+Comp+Attr+Der/vuota+N+Sg+Com
nuoralapvuohta	nuorra+N+Der/lasj+A+Comp+Attr+Der/vuota+N+Sg+Nom
nuoralasj	nuorra+N+Der/lasj+A+Attr
nuoralasj	nuorra+N+Der/lasj+A+Sg+Nom
nuoralasjvuoda	nuorra+N+Der/lasj+A+Attr+Der/vuota+N+Pl+Nom
nuoralasjvuodada	nuorra+N+Der/lasj+A+Attr+Der/vuota+N+Abe
nuoralasjvuodadagi	nuorra+N+Der/lasj+A+Attr+Der/vuota+N+Sg+Abe
nuoralasjvuodadagá	nuorra+N+Der/lasj+A+Attr+Der/vuota+N+Sg+Abe
nuoralasjvuodadak	nuorra+N+Der/lasj+A+Attr+Der/vuota+N+Abe
nuoralasjvuodaj	nuorra+N+Der/lasj+A+Attr+Der/vuota+N+Pl+Com
nuoralasjvuodajdagi	nuorra+N+Der/lasj+A+Attr+Der/vuota+N+Pl+Abe
nuoralasjvuodajdagá	nuorra+N+Der/lasj+A+Attr+Der/vuota+N+Pl+Abe
nuoralasjvuodajn	nuorra+N+Der/lasj+A+Attr+Der/vuota+N+Sg+Com
nuoralasjvuohta	nuorra+N+Der/lasj+A+Attr+Der/vuota+N+Sg+Nom
nuoralattja	nuorra+N+Der/lasj+A+Pl+Nom
nuoralattjadagi	nuorra+N+Der/lasj+A+Sg+Abe
nuoralattjadagá	nuorra+N+Der/lasj+A+Sg+Abe
nuoralattjaj	nuorra+N+Der/lasj+A+Pl+Com
nuoralattjajdagi	nuorra+N+Der/lasj+A+Pl+Abe
nuoralattjajdagá	nuorra+N+Der/lasj+A+Pl+Abe
nuoralattjajn	nuorra+N+Der/lasj+A+Sg+Com
nuoralattjat	nuorra+N+Der/lasj+A+Der/AAdv+Adv
nuoralup	nuorra+N+Der/lasj+A+Comp+Attr
nuoralupvuoda	nuorra+N+Der/lasj+A+Comp+Attr+Der/vuota+N+Pl+Nom
nuoralupvuodada	nuorra+N+Der/lasj+A+Comp+Attr+Der/vuota+N+Abe
nuoralupvuodadagi	nuorra+N+Der/lasj+A+Comp+Attr+Der/vuota+N+Sg+Abe
nuoralupvuodadagá	nuorra+N+Der/lasj+A+Comp+Attr+Der/vuota+N+Sg+Abe
nuoralupvuodadak	nuorra+N+Der/lasj+A+Comp+Attr+Der/vuota+N+Abe
nuoralupvuodaj	nuorra+N+Der/lasj+A+Comp+Attr+Der/vuota+N+Pl+Com
nuoralupvuodajdagi	nuorra+N+Der/lasj+A+Comp+Attr+Der/vuota+N+Pl+Abe
nuoralupvuodajdagá	nuorra+N+Der/lasj+A+Comp+Attr+Der/vuota+N+Pl+Abe
nuoralupvuodajn	nuorra+N+Der/lasj+A+Comp+Attr+Der/vuota+N+Sg+Com
nuoralupvuohta	nuorra+N+Der/lasj+A+Comp+Attr+Der/vuota+N+Sg+Nom
nuoramus	nuorra+A+Superl+Attr
nuoramus	nuorra+A+Superl+Sg+Nom
nuoramusá	nuorra+A+Superl+Pl+Nom
nuoramusádagi	nuorra+A+Superl+Sg+Abe
nuoramusádagá	nuorra+A+Superl+Sg+Abe
nuoramusáj	nuorra+A+Superl+Pl+Com
nuoramusájdagi	nuorra+A+Superl+Pl+Abe
nuoramusájdagá	nuorra+A+Superl+Pl+Abe
nuoramusájn	nuorra+A+Superl+Sg+Com
nuoramusájtagá	nuorra+A+Superl+Pl+Abe
nuoramusát	nuorra+A+Superl+Der/AAdv+Adv
nuoramusátagá	nuorra+A+Superl+Sg+Abe
nuorap	nuorra+A+Comp+Attr
nuorap	nuorra+A+Comp+Sg+Nom
nuorapvuoda	nuorra+A+Comp+Attr+Der/vuota+N+Pl+Nom
nuorapvuodada	nuorra+A+Comp+Attr+Der/vuota+N+Abe
nuorapvuodadagi	nuorra+A+Comp+Attr+Der/vuota+N+Sg+Abe
nuorapvuodadagá	nuorra+A+Comp+Attr+Der/vuota+N+Sg+Abe
nuorapvuodadak	nuorra+A+Comp+Attr+Der/vuota+N+Abe
nuorapvuodaj	nuorra+A+Comp+Attr+Der/vuota+N+Pl+Com
nuorapvuodajdagi	nuorra+A+Comp+Attr+Der/vuota+N+Pl+Abe
nuorapvuodajdagá	nuorra+A+Comp+Attr+Der/vuota+N+Pl+Abe
nuorapvuodajn	nuorra+A+Comp+Attr+Der/vuota+N+Sg+Com
nuorapvuohta	nuorra+A+Comp+Attr+Der/vuota+N+Sg+Nom
nuorasj	nuorra+N+Der/Dimin+N+Sg+Nom
nuorat	nuorra+A+Der/AAdv+Adv
nuoratja	nuorra+N+Der/Dimin+N+Pl+Nom
nuoratjadagi	nuorra+N+Der/Dimin+N+Sg+Abe
nuoratjadagá	nuorra+N+Der/Dimin+N+Sg+Abe
nuoratjasj	nuorra+N+Der/Dimin+N+Der/Dimin+N+Sg+Nom
nuoratjattja	nuorra+N+Der/Dimin+N+Der/Dimin+N+Pl+Nom
nuoratjattjadagi	nuorra+N+Der/Dimin+N+Der/Dimin+N+Sg+Abe
nuoratjattjadagá	nuorra+N+Der/Dimin+N+Der/Dimin+N+Sg+Abe
nuoratjattjaj	nuorra+N+Der/Dimin+N+Der/Dimin+N+Pl+Com
nuoratjattjajdagi	nuorra+N+Der/Dimin+N+Der/Dimin+N+Pl+Abe
nuoratjattjajdagá	nuorra+N+Der/Dimin+N+Der/Dimin+N+Pl+Abe
nuoratjattjajn	nuorra+N+Der/Dimin+N+Der/Dimin+N+Sg+Com
nuoratjij	nuorra+N+Der/Dimin+N+Pl+Com
nuoratjijdagi	nuorra+N+Der/Dimin+N+Pl+Abe
nuoratjijdagá	nuorra+N+Der/Dimin+N+Pl+Abe
nuoratjijn	nuorra+N+Der/Dimin+N+Sg+Com
nuorra	nuorra+A+Attr
nuorra	nuorra+A+Sg+Nom
nuorra	nuorra+N+Sg+Nom
nuorravuoda	nuorra+A+Attr+Der/vuota+N+Pl+Nom
nuorravuodada	nuorra+A+Attr+Der/vuota+N+Abe
nuorravuodadagi	nuorra+A+Attr+Der/vuota+N+Sg+Abe
nuorravuodadagá	nuorra+A+Attr+Der/vuota+N+Sg+Abe
nuorravuodadak	nuorra+A+Attr+Der/vuota+N+Abe
nuorravuodaj	nuorra+A+Attr+Der/vuota+N+Pl+Com
nuorravuodajdagi	nuorra+A+Attr+Der/vuota+N+Pl+Abe
nuorravuodajdagá	nuorra+A+Attr+Der/vuota+N+Pl+Abe
nuorravuodajn	nuorra+A+Attr+Der/vuota+N+Sg+Com
nuorravuohta	nuorra+A+Attr+Der/vuota+N+Sg+Nom
