AP-biedniga	AP-bied^ni^ga	# Acro + noun compound
ANC-gáddjo	ANC-gád^djo	# Acro + noun compound
10-bæjvvásattja	10-bæjv^vá^sat^tja	# Number + noun compound
10-biejvvásattja	10-biejv^vá^sat^tja	# Typo: Number + noun compound
moattesjattuga	moat^te#sjat^tu^ga	# Number + adj compound
guovtelågenanbájnuk	guov^te^lå^ge^nan#báj^nuk	# Number + adj compound
bargadallat	bar^ga^dal^lat	# Deverbal verb
bargadalátjavge	bar^ga^da^lá^tjav#ge	# Deverbal verb + clitc
duolmastasstet	duol^mas^tass^tet	# Deverbal verb
duolmmastasstet	duolm^mas^tass^tet	# Typo: Deverbal verb
duolmastastitjiga	duol^mas^tas^ti^tji#ga	# Deverbal verb + clitic
árjepluovegijda	ár^je^pluo^ve^gij^da	# Derivated noun - from name
jávrálattjan	jáv^rá^lat^tjan	# Denominal adj
niejdatjattjas	niej^da^tjat^tjas	# Denominal noun
vuosedahkes	vuo^se^dah^kes	# Deverbal adj
vuosedahkkásagen	vuo^se^dahk^ká^sa#gen	# Deverbal adj + clitic
juohkkajagák	juohk^ka#ja^gák	# Pronoun + adj compound
juohkkajagágijdaga	juohk^ka#ja^gá^gij^da#ga	# Pronoun + adj compound + clitic
biedjamus	bied^ja^mus	# Deverbal noun
bårrågoadáv	bår^rå^goa^dáv	# Deverbal verb
bassemgåvvimus	bas^sem#gåv^vi^mus	# Deverbal noun + deverbal noun compound
gielldesáhka	giell^de#sáh^ka	# Deverbal noun + noun compound
ielvvemgåvvåhivsik	ielv^vem#gåv^vå#hiv^sik	# Deverbal noun + noun + noun compound
gálvvobielkkeidja	gálv^vo#bielk^ke#id^ja	# Noun + deverbal noun + noun compound
umasslágásjgirddemuorra	u^mass#lá^gásj#gird^de#muor^ra	# Adj + denominal noun + adj/noun + noun
Oarjjelij-Bájddárij	Oarj^je^lij-Bájd^dá^rij	# Name
Norges-gruppenin	Nor^ges-grup^pe^nin	# Name
Tullingtoppen-gierge	Tul^ling^top^pen-gier^ge	# Name + noun compound
Koskivuori-plánimnævvo	Kos^ki^vuo^ri-plá^nim#næv^vo	# Name + noun + noun compound
lájkesvuodaláhkaåres	láj^kes^vuo^da#láh^ka#å^res	# Noun + noun + noun compound
låttemuoraielvvemisgen	låt^te#muo^ra#ielv^ve^mis#gen	# Noun + noun + deverbal noun + clitic
bájkeårråsijniejdajnga	báj^ke#år^rå^sij#niej^dajn#ga	# Noun + noun +noun + clitic
dábálasjvuodak	dá^bá^lasj^vuo^dak	# Deadjectival noun + clitic
lájkesvuohta	láj^kes^vuoh^ta	# Noun
lájkkevuohta	lájk^ke^vuoh^ta	# Typo: Noun
Jåhkåmåhkke	Jåh^kå^måhk^ke	# Name
Jåhkåmåkke	Jåh^kå^måk^ke	# Typo: Name
umasslágásj	u^mass^lá^gásj	# Adj
umaslágásj	u^mas^lá^gásj	# Typo: Adj
älváv	äl^váv	# Verb
ielváv	iel^váv	# Typo: Verb
Ålggorijkadepartementa	Ålg^go^rij^ka#de^par^te^men^ta	# Compound noun
Ålggorijkadepartemænta	Ålg^go^rij^ka#de^par^te^mæn^ta	# Typo: Compound noun
