ájgge	n
rabdda	n
nuortta	n
duohke	n
nuorajfálaldahka	n
oadádagá	n
hygiena	n
rábbi	n
juoksanásste	n
figuvrra	n
motåvrrå	n
telefåvnnå	n
nasjåvnnå	n
progresjåvnnå	n
visjåvnnå	n
konsesjåvnnå	n
eksáminásjåvnnå	n
proteijnna	n
masjijnna	n
lijggemotijvva	n
sámepolitihkka	n
diskotehkka	n
kandidáhtta	n
budsjæhtta	n
magnæhtta	n
sigaræhtta	n
asjæhtta	n
alfabehtta	n
rakehtta	n
partisihppa	n
biskoahppa	n
antologija	n
presidænnta	n
prosænnta	n
pasiænnta	n
semænnta	n
elefánnta	n
parabåvllå	n
paradijssa	n
objækta	n
prosjækta	n
tekstijlla	n
systebma	n
værbba	n
eksáminánnda	n
dividænnda	n
tabælla	n
areálla	n
telegrámma	n
fonebma	n
orgádna	n
sigárra	n
substánssa	n
valænssa	n
konkurssa	n
journalissta	n
gånågis	n
celsius	n
venagattja	n
ålggolij	n
viessomuj	n
sijddalahá	n
sissŋeluhá	n
gielov	n
tjuojkkavuojdas	n
bånstår	n
ájnát	n
suoja	n
dárba	n
rádnatja	n
iehkedisådåsa	n
jiednabeljas	n
maŋebu	n
bavsev	n
gårdal	n
rábev	n
sekkas	n
sjuváj	n
guovsojvuojoj	n
ritjas	n
tjålkes	n
iednep	n
sågas	n
ságe	n
sarves	n
guottoj	n
guomoj	n
gåhkes	n
gistá	n
sjávoårromvælggogisvuohta	n
gievrra	a
nuorra	a
hávsske	a
unne	a
sávadahtte	a
juhkke	a
ármmogis	a
ållagasj	a
asidasj	a
dárbbolasj	a
tjalmedibme	a
suolasiehke	a
nuorttalabbo	a
gasskalamos	a
dábbelij	a
tjiegos	a
basstel	a
mutták	a
allak	a
gåbddåk	a
galmas	a
suohkat	a
låssåt	a
dimes	a
bitjes	a
oames	a
tjalmmis	a
stuorak	a
sjkebtjas	a
sajij	a
árap	a
gæddámus	a
tsibtsa	a
ieŋŋils	a
gåntsas	a
dabár	a
snáves	a
tjuottjes	a
goavsos	a
suvres	a
galggat	v
vierttit	v
bieggat	v
galssjot	v
rássjudallat	v
ravggat	v
buollet	v
viedjet	v
máhttet	v
smarádaddat	v
áljistuvvat	v
bassat	v
juhkat	v
láhppet	v
jiehket	v
biedáldahttet	v
diehtet	v
gádjot	v
jårggot	v
bårssjot	v
vilssjot	v
tjirástit	v
unnedit	v
njoaredit	v
bånjådit	v
gahppelit	v
jållårit	v
sjkirnnjahit	v
bávkkodit	v
biedalit	v
sturjjanit	v
báhtarit	v
sjierrit	v
goallut	v
barggát	v
skáddut	v
roaddut	v
tsieggit	v
vallit	v
oaddut	v
Oslo	prop
Accra	prop
Amerijkka	prop
Saantensiijte	prop
Nystø	prop
London	prop
Korhonen	prop
Bern	prop
Alfheim	prop
Tjeldsund	prop
Bájdár	prop
Basudis	prop
Oalgesbelludahka	prop
Gaza-sárges	prop
Ivvárstáde	prop
Aleuhtat	prop
Kanáriasuollu	prop
Vuolleednama	prop
guokta	num
vihttalågenan	num
gietjavtjuode	num
