AP-biednig	AP-biedniga	# Acro + noun compound
ANC-gádjo	ANC-gáddjo	# Acro + noun compound
masste-NRK:an	masste-NRK:n	# Derivated noun + acro compound
st.diedravggalasstemin	St.died-ravggalasstemin	# Abbr + derivated noun compound
St.died-lájkkessarva	St.died-lájkesarva	# Abbr + adj + noun compound
10-bæjvvásadtja	10-bæjvvásattja	# Digit + noun compound
guoktesjattuga	guovtesjattuga	# Number + adj compound
guoktelågenanbájnugijnes	guovtelågenanbájnugijnes	# Number + adj compound
bargádallat	bargadallat	# Deverbal verb
bargadalatjavge	bargadalátjavge	# Deverbal verb + clitc
duolmmastasstebihtte	duolmastasstebihtte	# Deverbal verb
garvvelastin	garvvelasstin	# Deverbal verb
rævgudallop	revgudallop	# Deverbal verb
duolmastasstitjiga	duolmastastitjiga	# Deverbal verb + clitic
árjekluovegijda	árjepluovegijda	# Derivated noun - from name
jielleváregadoallvo	jielleváregadoalvvo	# Derivated noun - from name + deverbal noun
jávrrálattjan	jávrálattjan	# Denominal adj
niejddatjattjas	niejdatjattjas	# Denominal noun
vuosedahkánis	vuosedahkkánis	# Deverbal adj
vuosedahkásagen	vuosedahkkásagen	# Deverbal adj + clitic
juohkajagágijn	juohkkajagágijn	# Pronoun + adj compound
juohkajagágijdaga	juohkkajagágijdaga	# Pronoun + adj compound + clitic
bidjamussaj	biedjamussaj	# Deverbal noun
bårragoadáv	bårrågoadáv	# Deverbal verb
bassemgåvvemusáj	bassemgåvvimusáj	# Deverbal noun + deverbal noun compound
gieldesáhkasiska	gielldesáhkasiska	# Deverbal noun + noun compound
ielvvemgåvåhivsigav	ielvvemgåvvåhivsigav	# Deverbal noun + noun + noun compound
gálvvobielkeidjabiktasin	gálvvobielkkeidjabiktasin	# Noun + deverbal noun + noun + noun compound
umasslágátjgirddemuorav	umasslágásjgirddemuorav	# Adj + denominal noun + adj/noun + noun
Oarjelij-Bajddárij	Oarjjelij-Bájddárij	# Name
Norges-gruppenan	Norges-gruppenin	# Name
Tullintoppn-gierge	Tullingtoppen-gierge	# Name + noun compound
Koskkivuori-plánimnævvojt	Koskivuori-plánimnævvojt	# Name + noun + noun compound
lájkesvuohtaláhkaårråsijs	lájkesvuodaláhkaårråsijs	# Noun + noun + noun compound
låttemuorielvvemisgen	låttemuoraielvvemisgen	# Noun + noun + deverbal noun + clitic
bájkeårråsijtniejdajnga	bájkeårråsijniejdajnga	# Noun + noun +noun + clitic
dabalasjvuodak	dábálasjvuodak	# Deadjectival noun + clitic
lájkkesvuohtasisá	lájkesvuohtasisá	# Noun
Jåhkamåhkijda	Jåhkåmåhkijda	# Name
Jåhkamåhke-Váhtjera	Jåhkåmåhke-Váhtjera	# Name gen + name compound
umasslágátj	umasslágásj	# Adj
ielváv	älváv	# Verb
Ålggorjkadepartementa	Ålggorijkadepartementa	# Compound noun
báŋŋkaáutomáhtajn	báŋŋkaautomáhtajn	# Compound noun
láhppedahkesgarravuodajnimme	láhpedahkesgarravuodajnimme	# Deverbal adj + derivated noun compound
láhppambiernajs	láhppámbiernajs	# Infinite verb + noun
svierjjirijkkaladtjasis	svierjjirijkaladtjasis	# Prefix + derivated adj
vihttatjuotduhátgietjavtjuotvihtalåkguovtijn	vihttatjuotduhátgietjavtjuotvihttalåkguovtijn	# Number compound
vihttatjuotduhátgietjavtjuotvihtalåkguovtelágátjijda	vihttatjuotduhátgietjavtjuotvihttalåkguovtelágátjijda	# Number compound + adj compound
muorraprotokolgillijnam	muorraprotokollgillijnam	# Noun + noun + derived noun compound
gáttebujdda	gáttebujda	# Noun comparative
ilmedimijtduosstomijn	ilmedimijduosstomijn	# Derived adj + derived noun compound
tjittjegiehtjáj	tjittjegæhtjáj # Gen noun + noun compound
mieldahkamijnes	mieledahkamijnes	# Gen noun + noun compound